1,1,1,1,1,1
1,0,0,0,0,1
1,5,2,0,4,1
1,0,0,0,0,1
1,1,1,1,1,1
